////////Хоткеиe
iter	Итерация как в SDK 1.5 (цикл for)
inst	Проверка типа объекта через InstanceOf
itco	Итерирование элементов java.util.Collection
itit	Итерирование элементов java.util.Iterator
itli	Итерирование элементов java.util.List
psf	    Развертывание до public static final
thr   	Развертывание до throw new
sout	Развертывание до System.out.println()

////Поиск и замена
Ctrl + F	Поиск
Ctrl + Shift + F	Поиск в проекте
Ctrl + R	Замена
Ctrl + Shift + R	Замена в проекте

////Редактирование/генерация кода
Ctrl + Space	        Компоненты (классы, методы, переменные)
Ctrl + Shift + Space	«Смарт Код» — фильтрует по списку методов и переменных ожидаемого типа
Ctrl + F1	            Показать описания ошибки или предупреждения
+++Alt + Insert	        Генерируем код (Getters, Setters, Constructors, hashCode/equals, toString)
Ctrl + O	            Переопределяем метод
Ctrl + I	            Реализуем метод
+++Ctrl + Alt + T	        Помещаем часть кода в (if..else, try..catch, for, synchronized, etc.)

Ctrl + /	Однострочный комментарий / убрать комментарий
Ctrl + Shift + /	Много строчный комментарий / убрать комментарий
Alt + Enter	Показать исправление
Ctrl + Alt + L	Форматируем код
Ctrl + Alt + I	Авто-отступ линии
Tab / Shift + Tab	Отступ или удаление отступа выбранной части кода

++Ctrl + D	Дублировать строку
+Ctrl + Shift + U	Переключить стоящее слово рядом с кареткой в нижний / верхний регистр
Ctrl + Shift + ] / [	Выделить код до конца / начала блока
+Ctrl + NumPad+/-	Развернуть / свернуть блок кода
Ctrl + Shift + NumPad+	Развернуть все
Ctrl + Shift + NumPad-	Свернуть все

////Компиляция/выполнение/отладка
F9	«Резюме» программы

////Навигации
Alt + Right/Left	Перейти к следующей / предыдущей вкладки редактора
F12	Вернуть предыдущее окно инструмента
Ctrl + ] / [	Переход в конец / начало блока
Ctrl + F12	Показать файловую структуру
Ctrl + H	Показать иерархии типа
Ctrl + Shift + H	Показать иерархии метода
Ctrl + Alt + H	Показать иерархии вызовов
